▤▤▤▤▤▤▤▤▤▤▤▤▤▤▤▤▤▤▤▤▤▤▤▤▤▤▤▤▤▤▤▤▤▤▤▤▤▤▤▤▤▤▤▤▤▤▤▤▤▤▤▤▤▤▤▤▤▤▤▤▤▤▤▤▤▤▤▤▤▤▤▤▤▤▤▤▤▤▤▤
▤♣            ▤▤             ▤                 ▤   ▤▤     ▤      ▤   ▤   ▤    ▤▤
▤   ▤▤▤▤                     ▤                           ▤▤                    ▤
▤   ▤▤▤▤                                                  ▤                    ▤
▤                            ▤             ♣              ▤                    ▤
▤♣♣♣                         ▤             ♣          ☃                        ▤
▤♣♣♣♣    ▤▤▤▤▤▤▤▤            ▤                      ☃     ▤                    ▤
▤ ♣♣♣♣   ▤      ▤            ▤                    ☃       ▤                    ▤
▤  ♣     ▤      ▤            ▤                  ☃         ▤                    ▤
▤        ▤      ▤▤▤▤▤▤▤▤▤▤▤  ▤                 ☃          ▤                    ▤
▤    ♣   ▤                   ▤                  ☃         ▤                    ▤
▤        ▤                   ▤                    ☃       ▤                    ▤
▤        ▤▤▤▤▤▤▤▤▤▤▤▤▤▤▤▤▤▤▤▤▤                     ☃      ▤                    ▤
▤                            ▤                      ☃     ▤                    ▤
▤                  ♣         ▤                       ☃    ▤                    ▤
▤                            ▤                            ▤                    ▤
▤  ▤▤▤▤▤▤▤▤▤▤▤▤▤▤▤▤▤▤▤▤▤▤▤   ▤                            ▤                    ▤
▤  ▤                     ▤   ▤                            ▤                    ▤
▤  ▤                     ▤   ▤                            ▤                    ▤
▤  ▤                     ▤   ▤                            ▤▤▤▤▤▤▤▤▤▤▤▤▤▤▤▤▤▤▤▤ ▤
▤  ▤                     ▤▤▤▤▤                            ▤                  ▤ ▤
▤  ▤                         ▤                            ▤                  ▤ ▤
▤  ▤                         ▤                            ▤                  ▤ ▤
▤  ▤  ▤▤▤▤▤▤▤▤▤▤▤▤▤▤▤▤▤▤▤▤▤▤▤▤            ♣♣♣♣♣♣          ▤                  ▤ ▤
▤  ▤                         ▤             ♣♣♣♣           ▤                  ▤ ▤
▤  ▤                         ▤                            ▤                  ▤ ▤
▤  ▤                         ▤                            ▤     ▤▤▤▤▤▤▤▤▤▤▤▤▤▤ ▤
▤  ▤                         ▤                            ▤                  ▤ ▤
▤                            ▤                            ▤                    ▤
▤▤▤▤▤▤▤▤▤▤▤▤▤▤▤▤▤▤▤▤▤▤▤▤▤▤▤▤▤▤▤▤▤▤▤▤▤▤▤▤▤▤▤▤▤▤▤▤▤▤▤▤▤▤▤▤▤▤▤▤▤▤▤▤▤▤▤▤▤▤▤▤▤▤▤▤▤▤▤▤